13 13 13 13 13 13 13 13 13 13 13 13 13 13 13 13 13 13 13 13 13 13 13 13 13 13 13 13 13 13 13 13 13 13 13 13 13 13 13 13 13 13 13 13 13 13 13 13 13 13
13 13 13 13 13 13 13 13 13 13 13 13 13 13 13 13 13 13 13 13 13 13 14 13 13 14 13 13 14 13 14 13 13 13 13 13 13 13 13 13 13 13 13 13 14 13 13 13 13 13
13 13 13 13 13 13 13 13 13 13 13 13 13 13 13 13 13 13 13 14 14 13 14 14 14 14 14 14 14 14 14 13 13 13 13 13 13 13 13 13 13 14 13 13 13 13 13 13 13 13
13 17 18 18 18 18 18 18 18 18 18 18 18 18 18 18 18 18 19 17 18 18 18 18 18 18 18 18 18 18 18 18 18 18 18 18 18 18 18 18 18 18 18 18 18 18 18 19 13 13
13 20 10 10 10 10 10 10 10 10 10 10 10 10 10 10 10 10 21 22 23 23 23 23 23 23 26 23 23 23 23 23 23 23 23 23 23 23 23 23 23 23 23 23 27 27 26 24 13 13
13 20 10 10 10 10 10 10 10 10 10 10 10 10 10 10 10 10 10 28 28 29 29 29 29 29 29 29 29 29 29 23 23 23 23 23 23 23 23 23 23 23 23 23 23 23 23 24 13 13
13 20 10 10 10 10 10 10 10 10 10 10 10 10 10 10 10 10 10 28 28 28 28 28 28 28 28 28 28 28 29 23 23 23 23 23 23 23 23 23 23 23 23 23 23 27 23 24 13 13
13 20 10 10 10 10 10 10 10 10 10 10 10 10 10 10 10 10 10 28 28 28 28 28 28 28 28 28 28 28 29 23 23 23 23 23 23 23 30 30 30 23 23 23 23 23 23 24 13 13
13 20 10 10 10 10 10 10 10 10 10 10 10 10 10 10 10 10 10 28 28 29 29 29 29 29 29 28 28 28 29 23 23 23 23 23 23 23 30 30 30 23 23 23 23 23 23 24 13 13
13 20 10 10 10 10 10 10 10 10 10 10 10 10 10 10 10 10 10 28 28 29 29 29 29 29 29 28 28 28 29 23 23 23 23 23 23 23 30 30 30 23 23 23 27 27 27 24 13 13
13 20 34 10 10 10 10 10 10 10 10 10 10 10 10 10 10 10 17 18 18 18 18 18 19 29 29 28 28 28 29 23 23 23 23 23 23 23 30 14 30 23 31 23 23 14 14 24 13 13
13 21 25 25 25 25 32 29 28 28 29 32 25 25 25 25 25 25 22 26 26 26 31 31 24 29 29 28 28 28 29 23 23 23 23 23 23 23 30 30 30 23 23 23 23 23 23 24 13 13
13 13 13 13 13 13 24 29 28 28 29 20 13 13 13 13 13 32 26 26 26 26 31 31 24 29 29 28 28 28 29 23 23 23 23 23 23 23 30 30 30 23 23 23 23 23 23 24 13 13
13 13 13 13 13 13 24 29 28 28 29 20 13 13 13 13 13 32 26 26 26 26 31 31 24 29 29 28 28 28 29 23 23 23 23 23 23 14 14 14 14 23 23 23 27 27 27 24 13 13
14 14 14 14 14 14 24 29 28 28 29 20 14 14 14 14 14 32 31 31 31 31 31 31 24 25 25 25 25 25 25 25 32 23 23 23 23 23 23 14 14 23 23 23 23 23 34 24 13 13
14 14 14 14 14 14 24 29 28 28 29 20 14 14 14 14 14 32 31 31 31 31 31 31 24 18 18 18 18 18 18 32 32 23 23 23 23 23 23 32 18 18 18 18 18 18 18 24 13 13
14 14 14 14 14 14 24 29 28 28 29 20 14 14 14 14 14 32 31 31 31 31 31 31 24 31 31 31 31 31 31 31 31 31 31 31 31 31 31 31 31 31 31 31 31 31 31 24 14 13
14 14 14 14 14 14 24 29 28 28 29 20 14 14 14 14 14 32 31 31 31 31 31 31 24 31 31 31 31 31 31 31 31 31 31 31 31 31 31 31 31 31 31 31 31 31 31 24 13 13
12 12 12 12 12 12 24 29 28 28 29 20 12 12 12 12 12 32 31 31 31 31 31 31 24 31 31 31 31 31 31 31 31 31 31 31 31 31 31 31 31 31 31 31 31 31 31 24 13 13
12 12 12 12 12 12 24 29 28 28 29 20 12 12 12 12 12 32 31 31 31 31 31 31 24 31 31 31 31 31 31 31 31 31 31 31 31 31 31 31 31 31 31 31 31 31 31 24 13 13
12 12 12 12 12 12 24 29 28 28 29 20 12 12 12 12 12 32 31 31 31 32 25 25 22 31 31 31 31 31 31 31 31 31 31 31 31 31 31 31 31 31 31 31 31 31 31 24 13 13
12 12 12 12 12 12 24 29 28 28 29 20 12 12 12 12 12 32 31 31 31 31 31 31 31 31 31 31 31 31 31 31 31 31 31 31 31 31 31 31 31 31 31 31 31 31 31 24 13 13
12 12 12 12 12 12 24 29 28 28 29 20 12 12 12 12 12 32 31 31 31 31 31 31 31 31 31 31 31 31 31 31 31 17 18 18 18 18 32 31 31 31 31 31 32 18 18 24 14 13
12 12 12 12 12 12 24 29 28 28 29 20 12 12 12 12 12 32 31 31 31 31 31 31 31 31 31 31 31 31 31 31 31 20 28 28 28 28 28 29 29 29 29 29 28 33 33 24 13 13
12 12 12 12 12 12 24 29 28 28 29 20 12 12 12 12 12 32 31 31 31 31 31 31 31 31 31 31 31 31 31 31 31 20 28 28 28 28 28 29 29 29 29 29 28 28 33 24 13 13
12 12 12 12 12 12 24 29 28 28 29 20 12 12 12 12 12 32 31 31 31 31 31 31 31 31 31 31 31 31 31 31 31 20 28 28 28 28 28 29 29 29 29 29 28 28 28 24 13 13
12 12 12 12 12 12 24 29 28 28 29 20 12 12 12 12 12 32 31 31 31 31 31 31 31 31 31 31 31 31 31 31 31 20 28 28 28 28 28 29 29 29 29 29 28 28 28 24 13 13
14 17 18 18 18 18 32 29 28 28 29 32 18 18 18 18 18 32 34 34 34 34 34 34 34 34 34 34 34 34 34 34 34 20 28 28 28 28 29 29 29 29 29 29 28 28 28 24 13 13
14 20 34 34 34 34 34 34 34 34 34 34 34 34 34 34 34 34 34 34 34 34 34 34 34 34 34 34 34 34 34 34 34 20 28 28 28 28 29 29 29 29 29 29 28 28 28 24 13 13
14 20 34 34 34 34 34 34 34 34 34 34 34 34 34 34 34 34 34 34 34 34 34 34 34 34 34 34 34 34 34 34 34 20 28 28 28 28 28 29 29 29 29 29 28 28 28 24 13 13
14 20 34 34 34 34 34 34 34 34 34 34 34 34 34 34 34 34 34 34 34 34 34 34 34 34 34 34 34 34 34 34 34 20 28 28 28 28 28 29 29 29 28 28 28 28 28 24 13 13
14 20 34 34 34 34 34 34 34 34 34 34 34 34 34 34 34 34 34 34 34 34 34 34 34 34 34 34 34 34 34 34 34 20 28 28 28 28 28 29 29 29 28 28 28 28 28 24 14 13
14 20 34 34 34 34 31 31 31 31 31 31 34 34 34 34 31 31 34 34 31 31 31 31 31 31 34 34 34 34 34 34 34 32 28 28 28 28 28 29 29 28 28 28 28 28 28 24 13 13
14 20 34 34 34 34 31 31 31 31 31 31 34 34 34 34 31 31 34 34 31 31 31 31 31 31 34 34 34 34 34 34 34 31 31 31 34 32 18 18 18 18 18 18 18 18 18 24 13 13
14 20 34 34 34 34 31 31 34 34 31 31 34 34 34 34 31 31 34 34 34 34 31 31 34 34 34 34 34 34 34 34 34 34 34 34 34 34 34 34 34 34 33 33 34 34 34 24 13 13
14 20 34 34 34 34 31 31 34 34 31 31 34 34 34 34 31 31 34 34 34 34 31 31 34 34 34 34 34 34 34 34 34 34 34 34 34 34 34 34 34 34 34 34 34 34 34 24 13 13
14 20 34 34 34 34 31 31 34 34 31 31 34 34 34 34 31 31 34 34 34 34 31 31 34 34 34 34 34 34 34 34 34 34 34 34 34 34 34 34 34 34 34 34 34 34 34 24 13 13
14 20 34 34 34 34 31 31 31 31 31 31 34 34 34 34 31 31 34 34 34 34 31 31 34 34 34 34 34 34 34 34 34 34 34 34 34 34 34 34 34 34 34 34 34 34 34 24 13 13
14 20 34 34 34 34 31 31 31 31 31 31 34 34 34 34 31 31 33 33 33 34 31 31 34 34 34 34 34 34 34 34 34 34 34 34 34 34 34 34 34 34 34 34 34 34 34 24 13 13
14 20 34 34 34 34 31 31 34 31 31 31 34 34 34 34 31 31 33 33 33 34 31 31 34 34 34 34 34 34 34 34 34 34 34 34 34 34 34 34 34 34 34 34 34 34 34 24 13 13
14 20 34 34 34 34 31 31 34 34 31 31 34 34 34 34 31 31 33 33 33 34 31 31 34 34 34 34 34 34 34 34 34 34 34 34 34 13 34 34 34 34 34 34 34 34 24 24 13 13
14 20 34 34 34 34 34 34 34 34 34 34 34 34 34 34 34 34 33 33 33 34 34 34 34 34 34 34 34 34 34 34 34 34 34 34 13 13 14 34 34 34 34 34 34 34 34 24 13 13
14 20 34 34 34 34 34 34 34 34 34 34 34 34 34 34 34 34 34 34 34 34 34 34 34 34 34 34 34 34 34 34 34 34 34 34 13 14 14 34 13 34 34 34 34 34 34 24 13 13
14 20 34 34 34 34 34 34 34 34 34 34 34 34 34 34 34 34 34 34 34 34 34 34 34 34 34 34 34 34 34 34 34 34 34 34 13 14 14 34 13 34 34 34 34 34 34 24 13 34
14 20 34 34 34 34 34 34 34 34 34 34 34 34 34 34 34 34 34 34 34 34 34 34 34 34 34 34 34 34 34 34 34 34 34 34 13 14 14 34 13 13 34 34 34 34 34 24 13 34
14 21 25 25 25 25 25 25 25 25 25 25 25 25 25 25 25 25 25 25 25 25 25 25 25 25 25 25 25 25 25 25 25 25 25 25 25 25 25 25 25 25 25 25 25 25 25 22 20 20
14 14 14 14 14 14 14 14 14 14 14 14 14 14 14 14 14 14 14 14 14 14 14 14 14 14 14 14 14 14 14 14 14 14 14 14 14 14 14 14 14 14 14 14 14 14 14 14 14 14
14 14 14 14 14 14 14 14 14 14 14 14 14 14 14 14 14 14 14 14 14 14 14 14 14 14 14 14 14 14 14 14 14 14 14 14 14 14 14 14 14 14 14 14 14 14 14 14 14 14
14 14 14 14 14 14 14 14 14 14 14 14 14 14 14 14 14 14 14 14 14 14 14 14 14 14 14 14 14 14 14 14 14 14 14 14 14 14 14 14 14 14 14 14 14 14 14 14 14 14
14 14 14 14 14 14 14 14 14 14 14 14 14 14 14 14 14 14 14 14 14 14 14 14 14 14 14 14 14 14 14 32 14 14 14 14 14 14 14 14 14 14 14 14 14 14 14 14 14 14